222222222222222222222222222222222222222
211111111113111111113114114311111111312
231111111111111411111113111311111411112
213111131111131111111141111111114134112
211111114113111113311111111111311111112
211111111113111111111131111111114111112
213111411111114111111314131411111431112
233111411141113111111411111113131111112
211141111111111311114111111113111111132
211111111111111111311411111141111131112
211111111111131111111111111111111111112
211111111111111311141111114111311111112
211114111113411111111111141111111111112
211111111111341111113111311111111114312
211111311111111111111111111111111111112
211311111111113111141111111111111411142
211111111111111111131311111111111111112
211111111111114111111111411111111111132
211111131114111111111311111111311111142
211111111111111111311411111114411111312
211111411141111131111131111114311111112
211111111411411313114111114111111311112
211111113141111111111311111111141111112
211411111111111111111114111111111114312
211111311134111111111111111141111111112
211311111111111111111141111111111111112
213111111111113111111111311141111111112
214141111111111111111331111111111111112
211111131114111111111111111111111444112
211111111111111341111411111111111111412
211431111111111134111131111111111111112
213111111111111111443441111111113111132
213331111141113111111311111111111411112
213111114111111111111111141111111114112
211111111141311411111141111111111111112
211111111131111111314111414131141111112
211111111141411111111141111111111111132
211111111111111111111111111111111111312
211111111411111313111111141411111131412
222222222222222222222222222222222222222
